[x][x][x][x][x][x][x][x][x][x]
[x][x][x][x][x][x][x][x][x][x]
[x][B][x][x][x][x][x][x][x][B]
[x][x][B][B][x][B][x][B][B][x]
[x][x][x][x][B][x][B][x][x][x]
[x][x][x][x][B][B][B][x][x][x]
[x][x][B][B][x][B][x][B][B][x]
[x][B][x][x][x][x][x][x][x][B]
[x][x][x][x][x][x][x][x][x][x]
[x][x][x][x][x][x][x][x][x][x]